0001000000000000111100001
1000000100000110001000100
1000100011000100000100101
1001000101000100000100110
1001100101001000000100001
1010000011000100000111111
1010100100000110001011110
1011001010010010010101111
1011110011100101000110100
1100000000000000000000000
1100000001000110001000001
1100000010001100010100100
1100000011010010100000111
1100000100011000101101010
1100000101011110111001101
1100000110100101000110000
1100000111101011010010011
1100001000110001011110110
1100001001110111101011001
1100001010111101110111100
1100001011001010010000011
1100001100010000011100110
1100001101010110101001001
1100001110011100110101100
1100001111100011000001111